#######                                #######
#     #                                #     #
#     ##################################     #
#                                            #
#     ############## ###################     #
#     #            # #                 #     #
#######            # #                 #######
                   # #
                   # #
                   # #
                   # #
                 ### ###
                 #     #
                 #     #
                 #     #
                 #     #
                 #     #
                 #######